"filename", "language", "YAML", "Dart", "comment", "blank", "total"
"d:\flutter_projects\main\youtube-flutter-clone\lib\core\utility\injector.dart", "Dart", 0, 123, 0, 22, 145
"d:\flutter_projects\main\youtube-flutter-clone\lib\core\widgets\multi_bloc_provider.dart", "Dart", 0, 20, 0, 0, 20
"d:\flutter_projects\main\youtube-flutter-clone\lib\data\data_sources\remote\api\channel\channel_apis.dart", "Dart", 0, 16, 7, 1, 24
"d:\flutter_projects\main\youtube-flutter-clone\lib\data\data_sources\remote\api\channel\channel_apis.g.dart", "Dart", 0, 52, 0, 2, 54
"d:\flutter_projects\main\youtube-flutter-clone\lib\data\data_sources\remote\api\channel\channel_playlist\channel_playlist_apis.dart", "Dart", 0, 21, 0, 4, 25
"d:\flutter_projects\main\youtube-flutter-clone\lib\data\data_sources\remote\api\channel\channel_playlist\channel_playlist_apis.g.dart", "Dart", 0, 79, 5, 10, 94
"d:\flutter_projects\main\youtube-flutter-clone\lib\data\data_sources\remote\api\channel\channel_videos\channel_videos_apis.dart", "Dart", 0, 22, 0, 3, 25
"d:\flutter_projects\main\youtube-flutter-clone\lib\data\data_sources\remote\api\channel\channel_videos\channel_videos_apis.g.dart", "Dart", 0, 83, 5, 10, 98
"d:\flutter_projects\main\youtube-flutter-clone\lib\data\data_sources\remote\api\search\search_apis.dart", "Dart", 0, 5, 0, 1, 6
"d:\flutter_projects\main\youtube-flutter-clone\lib\data\data_sources\remote\api\search\search_apis.g.dart", "Dart", 0, 28, 0, 1, 29
"d:\flutter_projects\main\youtube-flutter-clone\lib\data\data_sources\remote\api\single_video\commet\comment_apis.dart", "Dart", 0, 32, 1, 6, 39
"d:\flutter_projects\main\youtube-flutter-clone\lib\data\data_sources\remote\api\single_video\commet\comment_apis.g.dart", "Dart", 0, 135, 5, 12, 152
"d:\flutter_projects\main\youtube-flutter-clone\lib\data\data_sources\remote\api\single_video\single_video_apis.dart", "Dart", 0, 21, 7, 5, 33
"d:\flutter_projects\main\youtube-flutter-clone\lib\data\data_sources\remote\api\single_video\single_video_apis.g.dart", "Dart", 0, 79, 5, 10, 94
"d:\flutter_projects\main\youtube-flutter-clone\lib\data\data_sources\remote\api\videos\videos_apis.dart", "Dart", 0, 10, 1, 2, 13
"d:\flutter_projects\main\youtube-flutter-clone\lib\data\data_sources\remote\api\videos\videos_apis.g.dart", "Dart", 0, 44, 0, 2, 46
"d:\flutter_projects\main\youtube-flutter-clone\lib\data\models\channel_details\channel_details.dart", "Dart", 0, -11, 0, -1, -12
"d:\flutter_projects\main\youtube-flutter-clone\lib\data\models\channel_details\my_subscriptions_details.dart", "Dart", 0, 47, 0, 14, 61
"d:\flutter_projects\main\youtube-flutter-clone\lib\data\models\channel_details\playlists\playlist_videos.dart", "Dart", 0, 56, 0, 14, 70
"d:\flutter_projects\main\youtube-flutter-clone\lib\data\models\channel_details\playlists\playlist_videos.g.dart", "Dart", 0, 51, 4, 7, 62
"d:\flutter_projects\main\youtube-flutter-clone\lib\data\models\channel_details\playlists\playlists.dart", "Dart", 0, 28, 0, 11, 39
"d:\flutter_projects\main\youtube-flutter-clone\lib\data\models\channel_details\playlists\playlists.g.dart", "Dart", 0, 27, 4, 6, 37
"d:\flutter_projects\main\youtube-flutter-clone\lib\data\models\channel_details\subscribe_request_body.dart", "Dart", 0, 12, 0, 1, 13
"d:\flutter_projects\main\youtube-flutter-clone\lib\data\models\comment_details\comment_body\comment_body.dart", "Dart", 0, 23, 0, 10, 33
"d:\flutter_projects\main\youtube-flutter-clone\lib\data\models\comment_details\comment_body\comment_body.g.dart", "Dart", 0, 21, 4, 7, 32
"d:\flutter_projects\main\youtube-flutter-clone\lib\data\models\comment_details\comment_details.dart", "Dart", 0, -24, 0, 1, -23
"d:\flutter_projects\main\youtube-flutter-clone\lib\data\models\comment_details\comment_details.g.dart", "Dart", 0, -14, 0, 0, -14
"d:\flutter_projects\main\youtube-flutter-clone\lib\data\models\comment_details\common\comment_snippet.dart", "Dart", 0, 0, 0, 1, 1
"d:\flutter_projects\main\youtube-flutter-clone\lib\data\models\common\base_comment_snippet\base_comment_snippet.dart", "Dart", 0, -28, 0, -5, -33
"d:\flutter_projects\main\youtube-flutter-clone\lib\data\models\common\base_comment_snippet\sub_comment_snippet.dart", "Dart", 0, 33, 0, 5, 38
"d:\flutter_projects\main\youtube-flutter-clone\lib\data\models\common\base_comment_snippet\sub_comment_snippet.g.dart", "Dart", 0, 19, 4, 4, 27
"d:\flutter_projects\main\youtube-flutter-clone\lib\data\models\common\base_snippet\base_snippet.dart", "Dart", 0, 21, 0, 6, 27
"d:\flutter_projects\main\youtube-flutter-clone\lib\data\models\common\base_snippet\base_snippet.g.dart", "Dart", 0, 13, 4, 4, 21
"d:\flutter_projects\main\youtube-flutter-clone\lib\data\models\common\thumbnail_details\max_thumbnail_details.dart", "Dart", 0, 16, 0, 6, 22
"d:\flutter_projects\main\youtube-flutter-clone\lib\data\models\common\thumbnail_details\max_thumbnail_details.g.dart", "Dart", 0, 20, 4, 4, 28
"d:\flutter_projects\main\youtube-flutter-clone\lib\data\models\common\videos_ids\videos_ids.dart", "Dart", 0, 29, 0, 11, 40
"d:\flutter_projects\main\youtube-flutter-clone\lib\data\models\common\videos_ids\videos_ids.g.dart", "Dart", 0, 24, 4, 6, 34
"d:\flutter_projects\main\youtube-flutter-clone\lib\data\models\reply_details\reply_details.dart", "Dart", 0, -34, 0, -2, -36
"d:\flutter_projects\main\youtube-flutter-clone\lib\data\models\reply_details\reply_details.g.dart", "Dart", 0, -19, 0, -1, -20
"d:\flutter_projects\main\youtube-flutter-clone\lib\data\models\video_details\video_details.dart", "Dart", 0, -115, 0, -25, -140
"d:\flutter_projects\main\youtube-flutter-clone\lib\data\models\video_details\video_details.g.dart", "Dart", 0, -75, -4, -10, -89
"d:\flutter_projects\main\youtube-flutter-clone\lib\data\models\videos_details\videos_details.dart", "Dart", 0, 103, 0, 21, 124
"d:\flutter_projects\main\youtube-flutter-clone\lib\data\models\videos_details\videos_details.g.dart", "Dart", 0, 57, 4, 9, 70
"d:\flutter_projects\main\youtube-flutter-clone\lib\data\repositories_impl\channel\channel_details_repo_impl.dart", "Dart", 0, 72, 0, 7, 79
"d:\flutter_projects\main\youtube-flutter-clone\lib\data\repositories_impl\channel\channel_playlist_repo_impl.dart", "Dart", 0, 33, 0, 7, 40
"d:\flutter_projects\main\youtube-flutter-clone\lib\data\repositories_impl\channel\channel_videos_repo_impl.dart", "Dart", 0, 67, 0, 15, 82
"d:\flutter_projects\main\youtube-flutter-clone\lib\data\repositories_impl\channel_details_repo_impl.dart", "Dart", 0, -20, 0, -3, -23
"d:\flutter_projects\main\youtube-flutter-clone\lib\data\repositories_impl\search_details_repo_impl.dart", "Dart", 0, 38, 0, 8, 46
"d:\flutter_projects\main\youtube-flutter-clone\lib\data\repositories_impl\single_video_details\single_video_details_repo_impl.dart", "Dart", 0, 37, 0, 7, 44
"d:\flutter_projects\main\youtube-flutter-clone\lib\data\repositories_impl\single_video_details\video_comment_details_repo_impl.dart", "Dart", 0, 43, 0, 6, 49
"d:\flutter_projects\main\youtube-flutter-clone\lib\data\repositories_impl\videos_details_repo_impl.dart", "Dart", 0, 41, 0, 11, 52
"d:\flutter_projects\main\youtube-flutter-clone\lib\domain\entities\channel_details_use_case_parameters.dart", "Dart", 0, 4, 0, 1, 5
"d:\flutter_projects\main\youtube-flutter-clone\lib\domain\entities\video_details_use_case_parameter.dart", "Dart", 0, 4, 0, 2, 6
"d:\flutter_projects\main\youtube-flutter-clone\lib\domain\repositories\channel\channel_details_repository.dart", "Dart", 0, 13, 0, 2, 15
"d:\flutter_projects\main\youtube-flutter-clone\lib\domain\repositories\channel\channel_playlist_repository.dart", "Dart", 0, 9, 0, 3, 12
"d:\flutter_projects\main\youtube-flutter-clone\lib\domain\repositories\channel\channel_videos_repository.dart", "Dart", 0, 16, 0, 4, 20
"d:\flutter_projects\main\youtube-flutter-clone\lib\domain\repositories\channel_details_repository.dart", "Dart", 0, -6, 0, -2, -8
"d:\flutter_projects\main\youtube-flutter-clone\lib\domain\repositories\search_details_repository.dart", "Dart", 0, 8, 0, 2, 10
"d:\flutter_projects\main\youtube-flutter-clone\lib\domain\repositories\video_comment_details\single_video_details_repository.dart", "Dart", 0, 6, 0, 2, 8
"d:\flutter_projects\main\youtube-flutter-clone\lib\domain\repositories\video_comment_details\video_comment_details_repositroy.dart", "Dart", 0, 9, 0, 2, 11
"d:\flutter_projects\main\youtube-flutter-clone\lib\domain\repositories\videos_details_repository.dart", "Dart", 0, 4, 0, 0, 4
"d:\flutter_projects\main\youtube-flutter-clone\lib\domain\use_cases\channel_details\channel_sub_details_use_case.dart", "Dart", 0, -3, 0, -2, -5
"d:\flutter_projects\main\youtube-flutter-clone\lib\domain\use_cases\channel_details\channel_videos\channel_popular_videos_use_case.dart", "Dart", 0, 19, 0, 4, 23
"d:\flutter_projects\main\youtube-flutter-clone\lib\domain\use_cases\channel_details\channel_videos\channel_short_poupal_videos_use_case.dart", "Dart", 0, 19, 0, 4, 23
"d:\flutter_projects\main\youtube-flutter-clone\lib\domain\use_cases\channel_details\channel_videos\channel_short_videos_use_case.dart", "Dart", 0, 19, 0, 4, 23
"d:\flutter_projects\main\youtube-flutter-clone\lib\domain\use_cases\channel_details\channel_videos\channel_videos_use_case.dart", "Dart", 0, 19, 0, 4, 23
"d:\flutter_projects\main\youtube-flutter-clone\lib\domain\use_cases\channel_details\delete_subscription_use_case.dart", "Dart", 0, 13, 0, 4, 17
"d:\flutter_projects\main\youtube-flutter-clone\lib\domain\use_cases\channel_details\my_subscriptions_channels_use_case.dart", "Dart", 0, 13, 0, 4, 17
"d:\flutter_projects\main\youtube-flutter-clone\lib\domain\use_cases\channel_details\playlist\channel_playlist_items_use_case.dart", "Dart", 0, 21, 0, 6, 27
"d:\flutter_projects\main\youtube-flutter-clone\lib\domain\use_cases\channel_details\playlist\channel_playlists_use_case.dart", "Dart", 0, 16, 0, 4, 20
"d:\flutter_projects\main\youtube-flutter-clone\lib\domain\use_cases\channel_details\subscribe_to_channel_use_case.dart", "Dart", 0, 16, 0, 4, 20
"d:\flutter_projects\main\youtube-flutter-clone\lib\domain\use_cases\search_details\related_videos_to_this_video_use_case.dart", "Dart", 0, 20, 0, 5, 25
"d:\flutter_projects\main\youtube-flutter-clone\lib\domain\use_cases\search_details\search_for_this_sentence_use_case.dart", "Dart", 0, 20, 0, 5, 25
"d:\flutter_projects\main\youtube-flutter-clone\lib\domain\use_cases\single_video\comment\get_all_comments_use_case.dart", "Dart", 0, 16, 0, 4, 20
"d:\flutter_projects\main\youtube-flutter-clone\lib\domain\use_cases\single_video\comment\get_all_replies_use_case.dart", "Dart", 0, 19, 0, 6, 25
"d:\flutter_projects\main\youtube-flutter-clone\lib\domain\use_cases\single_video\comment\get_first_comment_use_case.dart", "Dart", 0, 16, 0, 4, 20
"d:\flutter_projects\main\youtube-flutter-clone\lib\domain\use_cases\single_video\get_video_details_use_case.dart", "Dart", 0, 16, 0, 4, 20
"d:\flutter_projects\main\youtube-flutter-clone\lib\domain\use_cases\single_video\rate_video_use_case.dart", "Dart", 0, 16, 7, 7, 30
"d:\flutter_projects\main\youtube-flutter-clone\lib\domain\use_cases\videos_details\all_short_videos_use_case.dart", "Dart", 0, 12, 0, 4, 16
"d:\flutter_projects\main\youtube-flutter-clone\lib\domain\use_cases\videos_details\all_videos_use_case.dart", "Dart", 0, 13, 0, 4, 17
"d:\flutter_projects\main\youtube-flutter-clone\lib\domain\use_cases\videos_details\get_video_details_usecase.dart", "Dart", 0, -19, 0, -5, -24
"d:\flutter_projects\main\youtube-flutter-clone\lib\main.dart", "Dart", 0, 14, 0, 1, 15
"d:\flutter_projects\main\youtube-flutter-clone\lib\presentation\common_widgets\mini_player_video.dart", "Dart", 0, 37, 0, 7, 44
"d:\flutter_projects\main\youtube-flutter-clone\lib\presentation\common_widgets\moved_thumbnail_video.dart", "Dart", 0, 2, 0, 0, 2
"d:\flutter_projects\main\youtube-flutter-clone\lib\presentation\cubit\channel\channel_details_cubit.dart", "Dart", 0, 64, 0, 17, 81
"d:\flutter_projects\main\youtube-flutter-clone\lib\presentation\cubit\channel\channel_details_cubit.freezed.dart", "Dart", 0, 837, 30, 103, 970
"d:\flutter_projects\main\youtube-flutter-clone\lib\presentation\cubit\channel\channel_details_state.dart", "Dart", 0, 16, 0, 8, 24
"d:\flutter_projects\main\youtube-flutter-clone\lib\presentation\cubit\channel\channel_videos\channel_videos_cubit.dart", "Dart", 0, 61, 0, 17, 78
"d:\flutter_projects\main\youtube-flutter-clone\lib\presentation\cubit\channel\channel_videos\channel_videos_cubit.freezed.dart", "Dart", 0, 1056, 33, 129, 1218
"d:\flutter_projects\main\youtube-flutter-clone\lib\presentation\cubit\channel\channel_videos\channel_videos_state.dart", "Dart", 0, 16, 0, 8, 24
"d:\flutter_projects\main\youtube-flutter-clone\lib\presentation\cubit\channel\playlist\play_list_cubit.dart", "Dart", 0, 39, 0, 11, 50
"d:\flutter_projects\main\youtube-flutter-clone\lib\presentation\cubit\channel\playlist\play_list_cubit.freezed.dart", "Dart", 0, 690, 27, 93, 810
"d:\flutter_projects\main\youtube-flutter-clone\lib\presentation\cubit\channel\playlist\play_list_state.dart", "Dart", 0, 13, 0, 7, 20
"d:\flutter_projects\main\youtube-flutter-clone\lib\presentation\cubit\search\search_cubit.dart", "Dart", 0, 39, 0, 11, 50
"d:\flutter_projects\main\youtube-flutter-clone\lib\presentation\cubit\search\search_cubit.freezed.dart", "Dart", 0, 704, 27, 93, 824
"d:\flutter_projects\main\youtube-flutter-clone\lib\presentation\cubit\search\search_state.dart", "Dart", 0, 11, 0, 6, 17
"d:\flutter_projects\main\youtube-flutter-clone\lib\presentation\cubit\single_video\single_video_cubit.dart", "Dart", 0, 66, 0, 16, 82
"d:\flutter_projects\main\youtube-flutter-clone\lib\presentation\cubit\single_video\single_video_cubit.freezed.dart", "Dart", 0, 1054, 33, 129, 1216
"d:\flutter_projects\main\youtube-flutter-clone\lib\presentation\cubit\single_video\single_video_state.dart", "Dart", 0, 16, 0, 8, 24
"d:\flutter_projects\main\youtube-flutter-clone\lib\presentation\cubit\videos\videos_details_cubit.dart", "Dart", 0, 50, 0, 13, 63
"d:\flutter_projects\main\youtube-flutter-clone\lib\presentation\cubit\videos\videos_details_cubit.freezed.dart", "Dart", 0, 873, 30, 111, 1014
"d:\flutter_projects\main\youtube-flutter-clone\lib\presentation\cubit\videos\videos_details_state.dart", "Dart", 0, 14, 0, 7, 21
"d:\flutter_projects\main\youtube-flutter-clone\lib\presentation\cubit\videos_details\videos_details_cubit.dart", "Dart", 0, -63, 0, -14, -77
"d:\flutter_projects\main\youtube-flutter-clone\lib\presentation\cubit\videos_details\videos_details_cubit.freezed.dart", "Dart", 0, -690, -27, -93, -810
"d:\flutter_projects\main\youtube-flutter-clone\lib\presentation\cubit\videos_details\videos_details_state.dart", "Dart", 0, -12, 0, -6, -18
"d:\flutter_projects\main\youtube-flutter-clone\lib\presentation\pages\home\logic\home_page_logic.dart", "Dart", 0, 6, 0, -1, 5
"d:\flutter_projects\main\youtube-flutter-clone\pubspec.yaml", "YAML", 1, 0, 0, 0, 1
"Total", "-", 1, 6622, 224, 1024, 7871